[MAP]
24 24
1 1 1 1 1 1 1 1 1 1 1 1 1 1 1 1 1 1 1 1 1 1 1 1
1 0 0 0 0 0 0 0 0 0 0 0 0 0 0 0 0 0 0 0 0 0 0 1
1 0 2 2 2 2 2 2 0 0 3 3 3 3 3 3 0 0 4 4 4 0 0 1
1 0 2 0 0 0 0 2 0 0 3 0 0 0 0 3 0 0 4 0 4 0 0 1
1 0 2 0 5 5 0 2 0 0 3 0 0 0 0 3 0 0 4 0 4 0 0 1
1 0 2 0 5 5 0 2 0 0 3 3 0 3 3 3 0 0 4 4 4 0 0 1
1 0 2 0 0 0 0 2 0 0 0 0 0 0 0 0 0 0 0 0 0 0 0 1
1 0 2 2 0 2 2 2 0 0 0 0 0 0 0 0 0 0 0 0 0 0 0 1
1 0 0 0 0 0 0 0 0 0 5 0 5 0 5 0 5 0 0 0 0 0 0 1
1 0 0 0 0 0 0 0 0 0 0 0 0 0 0 0 0 0 0 0 0 0 0 1
1 1 1 1 1 0 1 1 1 1 1 1 1 1 1 1 1 1 1 0 1 1 1 1
1 0 0 0 0 0 0 0 0 0 0 0 0 0 0 0 0 0 0 0 0 0 0 1
1 0 3 3 3 0 0 0 0 0 0 0 0 0 0 0 0 0 0 0 0 0 0 1
1 0 3 0 3 0 0 2 2 2 2 2 2 2 2 2 2 2 0 0 5 0 0 1
1 0 3 0 3 0 0 2 0 0 0 0 0 0 0 0 0 2 0 0 0 0 0 1
1 0 3 0 3 0 0 2 0 0 4 0 0 0 0 4 0 2 0 0 5 0 0 1
1 0 3 3 3 0 0 2 0 0 0 0 0 0 0 0 0 2 0 0 0 0 0 1
1 0 0 0 0 0 0 2 0 0 4 0 0 0 0 4 0 2 0 0 5 0 0 1
1 0 0 0 0 0 0 2 0 0 0 0 0 0 0 0 0 2 0 0 0 0 0 1
1 0 0 0 0 0 0 2 2 2 2 2 0 2 2 2 2 2 0 0 5 0 0 1
1 0 0 0 0 0 0 0 0 0 0 0 0 0 0 0 0 0 0 0 0 0 0 1
1 0 0 0 0 0 0 0 0 0 0 0 0 0 0 0 0 0 0 0 5 0 0 1
1 0 0 0 0 0 0 0 0 0 0 0 0 0 0 0 0 0 0 0 0 0 0 1
1 1 1 1 1 1 1 1 1 1 1 1 1 1 1 1 1 1 1 1 1 1 1 1

[ENEMIES]
5
18.5 4.5 1 60
10.0 4.5 2 40
20.5 11.5 3 150
10.0 12.5 3 150
14.0 10.5 4 80

[ITEMS]
1
18.5 12.5 8 0