[MAP]
24 24
1 1 1 1 1 1 1 1 1 1 1 1 1 1 1 1 1 1 1 1 1 1 1 1
1 0 0 0 0 0 0 1 0 0 0 0 0 0 0 1 0 0 0 0 0 0 0 1
1 0 0 0 0 0 0 1 0 3 3 0 3 3 0 1 0 4 4 4 4 4 0 1
1 0 0 1 1 0 0 1 0 3 0 0 0 3 0 1 0 4 0 0 0 4 0 1
1 0 0 1 1 0 0 0 0 3 0 0 0 3 0 0 0 4 0 5 0 4 0 1
1 1 0 1 1 0 0 1 0 3 3 0 3 3 0 1 0 4 0 0 0 4 0 1
1 0 0 0 0 0 0 1 0 0 0 0 0 0 0 1 0 4 4 0 4 4 0 1
1 0 1 1 1 1 1 1 1 1 0 1 1 1 1 1 0 0 0 0 0 0 0 1
1 0 0 0 0 0 0 0 0 1 0 1 0 0 0 0 0 1 1 0 1 1 1 1
1 1 1 1 1 1 1 0 0 1 0 1 0 1 1 1 1 1 0 0 0 0 0 1
1 0 0 0 0 0 1 0 0 0 0 0 0 1 0 0 0 0 0 2 2 2 0 1
1 0 5 5 5 0 1 0 0 1 0 1 0 1 0 5 5 5 0 2 0 2 0 1
1 0 5 0 5 0 1 1 1 1 0 1 1 1 0 5 0 5 0 2 2 2 0 1
1 0 5 5 5 0 0 0 0 0 0 0 0 0 0 5 5 5 0 0 0 0 0 1
1 0 0 0 0 0 1 1 1 1 0 1 1 1 1 0 0 0 0 1 1 1 1 1
1 1 1 0 1 1 1 0 0 1 0 1 0 0 1 1 1 0 0 1 0 0 0 1
1 0 0 0 0 0 1 0 0 1 0 1 0 0 1 0 0 0 0 1 0 3 0 1
1 0 4 4 4 0 1 0 0 0 0 0 0 0 1 0 2 2 0 1 0 0 0 1
1 0 4 0 4 0 1 0 0 1 0 1 0 0 1 0 2 2 0 0 0 3 0 1
1 0 4 4 4 0 1 1 1 1 1 1 1 1 1 0 0 0 0 1 0 0 0 1
1 0 0 0 0 0 0 0 0 0 0 0 0 0 0 0 1 1 1 1 1 1 0 1
1 0 1 1 1 1 1 1 1 0 0 0 1 1 1 1 1 0 0 0 0 0 0 1
1 0 0 0 0 0 0 0 1 0 0 0 1 0 0 0 0 0 0 0 0 0 0 1
1 1 1 1 1 1 1 1 1 1 1 1 1 1 1 1 1 1 1 1 1 1 1 1

[ENEMIES]
4
11.5 3.5 2 40
20.5 4.5 4 60
20.5 17.5 3 100
16.5 18.5 1 50

[ITEMS]
3
4.5 4.5 8 0
16.5 12.5 8 0
2.5 22.5 8 0